1111111111111111111111111111111111111111
1                                      1
1                   3                  1
1                                      1
1                                      1
1   111                                1
1   111                                1
1                                      1
1                                      1
1                                      1
1     222                              1
1     2 2                   2222222    1
1     222                              1
1                                      1
1          1111                        1
1    222222222222           6          1
1                2                     1
1               22222222    6          1
1           6       6           6      1
1           5         5 5        5     1
1                                      1
1222222222222222222222222222222222222221
1                                      1
1    222                               1
1                   5           2222   1
1                                      1
1                                      1
1                  2222222             1
1                  2                   1
1      2222222     2           11      1
1            2222222           11      1
1            1111                      1
1                                      1
1           6               6          1
1      111                             1
1      111                             1
1                   4                  1
1                                      1
1                                      1
1111111111111111111111111111111111111111